0 0 40 30
1111111111111111111111111111111111111111
0000000000000000000000000000010000000001
0000000000000000000000000000010000000001
0000000000000000000010000000000000000001
0000000000000000000010000000000000000001
0000000000000001111111111111111111111111
0000000000000001000000000000000000000000
0000000000000001000000000000000000000000
0000000000001111000000000000000000000001
0000000000000001000000000000000000000001
0100000000000001000011111111000000000001
0111111110000000000010000000000000000001
0000000000000000000010000000000000111111
0000000001111111111110000000000000100000
0000000000000000000000000000000000100000
0000000000000000000000000000001111100000
1000000000000000000000000000001000000000
1000000000000000000000000000001000000000
1000000000011111110000000000001000000000
1111000000000000000000001111111000000000
0000000000000000000100000000000000000000
0000000001111000011100000000000000000000
0000000000001000000000000000000000000000
0000000000001000000000000000000001000000
0000000000001000000000000000000001000000
0000000000001111110000000000000001000000
0000000000000000000000000000111111000000
0000000000000000000000000000000000000000
0000000000000000000000000000000000000000
1111111111111111111111111111111111111111