0 0 30 25
000000000000000000000000000000
000000000000000000000000000000
000000000000000000000000000000
000000000000000000000000000000
000000000001000000000000000000
000000000001000000000000000000
000000000001000000001111111000
000000000001100000000000001000
000000000001100000000000001000
000000000001100000000000001111
000000000001000000000000000001
000000000001000000000000000001
111111111111000000000000000001
111000000001000000000000000001
111000000001000000000000000001
111000000001000000000000000001
111000000001003000000000000001
111000110001111111111110000001
111000110000000000000000000001
111000110000000000000000000001
000000110000000000000000000001
000000110000000000000000000001
000000110000000000000000000001
200000110000000000000000000001
110000110000000000111111111111