0 0 30 30
000000000000000000000000000000
000000000000000000000000000000
000000000000000000000000000000
000000000000000000000000000000
000000000000000000000000000000
000000011111111111111111100000
000000000000000000000000000000
000000000000000000000000000000
000000000000000110000000000110
000000000000000110000000000110
000000000000000110000000000110
000000000000000110000000000110
000000000000000110000000000110
000011111000000000000000000000
000010000000000000000000000000
001110000000000000000000000000
000000000000000000011111111111
111111111111000000000000000001
111000000001000000000000000001
111000000001000000000000000001
111000000001000000000000000001
111000000001000000000000000001
111000110001111111111110000001
111000110000000000000000000001
111000110000000000000000000001
000000110000000000000000000001
000000110000000000000000000001
000000110000000000000000000001
000000110000000000000000000001
110000110000000000111111111111