0 0 30 20
000000000000000000000000000000
000000000000000000000000000000
000000000000000000000000000000
000000000000000000000000000000
000000000000000000000000000000
000000000000000000000000000000
000000000500000000000000000000
000000000100000000000000000000
000000000100000000050000000000
000000000100000000010000000000
000000000100000000010000000000
000000000100000000010000000000
000000000155555000410000000000
000000000111111000010000000000
000000000000000000010000000000
111111000000000000010001111111
000001000000000000010001000000
000001000000000000000001000000
000001000000000000000001000000
000001000000000000000001000000
30 0 30 25
100001111111111111111111111111
100000000000000000000000000001
100000000000000000000000000001
100000000000000000000000000001
100000000000000000000000000001
111111111111110000000000000001
000001111111110000000000000001
000001111111110000000000000001
000000000111110000000000000001
000000000111110000000000000001
000000000111110000000111111111
000000000111110000000100000000
000000000111110000000100000000
000000000111111000000100000000
000000000110000000000100000000
111110000110000000000100000000
000010000000000000000100000000
000010000000000000000100000000
000010000000000000400100000000
000010000000000000000100000000
000010000000000000000100000000
000010000000000055555100000000
000010000000000011111100000000
000010000000000000000100000000
000010000000000000000100000000
30 -20 30 20
000000000000000000000000000000
000000000000000000000000000000
000000000000000000000000000000
000000000000000000000000000000
000000000000000000000000000000
000000000000000000000000000000
000000000000000000000000000000
000000000000000000000000000000
000000000000000000000000000000
000000000000000000000000000000
000000000000000000000000000000
000000000000000000000000000000
000000000000000000000000000000
000000000000000000000000000000
111111111111111111100000000000
100000000000000000000000000000
100000000000000000000000000000
100000000000000000000000000000
100000000000000000000000000000
100001111111111111111111111111
0 -20 30 20
111111111111111111111111111111
111111111111111111111111111111
111111111111111111111111111111
111111110000000000000111111111
111110000000000000000000011111
000000000000000000000000000000
000000000000000000000000000000
000000000000000000000000000000
000000000005000005000000000000
000000000001000001000000000000
000000000001004001000000000000
000000000001000001000000000000
000000000001000001000000000000
000000000001000001000000000000
000000000001000001000000000000
200000000001000001000000000000
111111110001000001000011111111
111111110001000001000011111111
111111110001000001000011111111
111111110001000001000011111111