0 0 30 20
000000000000000000000000000000
000000000000000000000000000000
000000000000000000000000000000
000000000000000000000000000000
000000000000000000000000000000
000000000000000000000000000000
000000000500000000000000000000
000000000100000000000000000000
000000000100000000050000000000
000000000100000000010000000000
000000000100000000010000000000
000000000100000000010000000000
000000000155555000410000000000
000000000111111000010000000000
000000000000000000010000000000
111111000000000000010001111111
000001000000000000010001000000
000001000000000000000001000000
000001000000000000000001000000
000001000000000000000001000000
30 0 30 25
100001111111000000000000011111
100000000000000000000000011111
100000000000000000000000001111
100000000000000000000000001111
100000000001111000000000001111
111111111111111000000000001111
000001111111111000000000001111
000001111111110000000000001111
000000000111110000000000771111
000000000111110000000000001111
000000000111110000000555551111
000000000111110000000111111111
000000000111110000000111100000
000000000111117700000111100000
204000000111110000000111100000
111110000111110000000111100000
000010000000000000000111100000
000010000000000000000111100000
000010000000000000400111100000
000010000000000000000111100000
000010000000000000000111100000
000010000000000055555111100000
000010000000000011111111100000
000010000000000000000111100000
000010000000000000000111100000
30 -20 30 20
000000000000000000000000000000
000000000000000000000000000000
000000000000000000000000000000
000000000000000000000000000000
000000000000000000000000000000
000000000000000000000000000000
000000000000000000000000000000
000000000000000000000000000000
000000000000000000000000000000
000000000000000000000000000000
000000000000000000000000000000
000000000000000000000000000000
000000000000000000000000000000
000000033300030030000000000000
111111111111111111100000000000
100000000000000000000000000000
100000000000000000000000000000
100000000000000000001000000000
100000000000000000001010000000
177771111111111111111111111111
0 -20 30 20
111111111111111111111111111111
111111111111111111111111111111
111111111111111111111111111111
111111110000000000000111111111
111110000000000000000000011111
000000000000000000000000000000
000000000000000000000000000000
000000000000000000000000000000
000000000005000005000000000000
000000000001000001000000000000
000000000001004001000000000000
000000000001000001000000000000
000000000001000001000000000000
000000000001000001000000000000
000000000001000001000000000000
000000000001000001000000000000
111111110001000001000011111111
111111110001000001000011111111
111111110001000001000011111111
111111110001000001000011111111